NO ./textures/Lana_1.xpm
SO ./textures/Lana_2.xpm
WE ./textures/Lana_3.xpm
EA ./textures/Lana_4.xpm

F 50,50                            ,	50 

C 229,229,239



	1111111111111111111111111
	10000000001100011110000001
	1011000001110001  1111101
	1001000000000001111111101
11111111101100000111000000001
10000000001100000111111001001          
11110111111111000000E00000001						
11110111111111011101010000011						
110000001101010111000001O1001
100000000000000011000011C1001
10000000000000001101010000001
1000000111010101111101110S0011
11110111111101011101111000001 			
11111111111111111111111111111




