NO ./textures/Lana_1.xpm
SO ./textures/Lana_2.xpm
WE ./textures/Lana_3.xpm
EA ./textures/alo.xpm

F 50,50                            ,	50 

C 229,229,239



	1111111111111111111111111
	1000000000110001111000001
	1011000001110001  1111101
	1001000000000001111111101
11111111101100000111000000001
10000000001100000111111001001          
11110111111111000000000000001						
11110111111111011101010000011						
110000001101010111000001O1001
100000000000000011000011C1001
10000000000000001101010000001     111111
1000000111010101111101110N0011   110011
11110111111101011101111000001 	11111111	
1111111111111111111111111111