NO ./textures/Lana_1.xpm
SO ./textures/Lana_2.xpm
WE ./textures/Lana_3.xpm
EA ./textures/Lana_4.xpm

F 50,50,50

C 229,229,239




	1111111111111111111111111
	1000000000110000000000001
	10110000011100000001111101
	10010000000000000001111001
111111111011000001110000001111
100000000011000001111111011111
11110111111111000000000000001
11110111111111011101010000011
110000001101010111000001O1001
100000000000000011000011C1001
10000000000000001101010000001
1100000111010101111101110N0111
11110111111101011101111000001
11111111111111111111111111111