NO textures/Lana_1.xpm
SO textures/Lana_2.xpm
WE textures/Lana_3.xpm
EA textures/Lana_4.xpm

F 157,188,227
C 141, 161,             141




		1111111111111111111111111
		1000000000110000000000001
		10110000011100000001111101
		10010000000000000001111001
111111111011000001110000000000001
1000000000110000011101110000111111
11110111111111011100000000001
11110111111111011101010000011
11000000110101011100000000001
10000000000000001100000000001
10000000000000001101010000001
11000001110101011111011100N0111
11110111 1110101 101111000001
11111111 1111111 111111111111