NO textures/wall.xpm
SO textures/wall.xpm
WE textures/wall.xpm
EA textures/lana.xpm

F 220,100,2
C 225,30,0

		1111111111111111111111111
		1000000000110000000000001
		1011011111111111111111001
11111111111111111            1011
11111111101111111111111111111111
1000000010110000111101111111100111
11101111101110101000000100000011
1111011111111101110101001000111
11000000110101011100000010001
100000011111000011000000100011111
10000001   100000000011010100000011
11000001111101011111011100N111111
11110111 1110101 101111010001
11111111 1111111 111111111111