NO textures/wall.xpm
SO textures/wall.xpm
WE textures/wall.xpm
EA textures/lana.xpm

F 220,100,2
C 225,30,0

		1111111111111111111111111
		1000000000110000000000001
		1011000011111111111111001
		100100001            1001
111111111011000011111111111111001
1000000000110000011101111111100111
11110111111111011100000010000001
1111011111111101110101001000111
11000000110101011100000010001
10000000000000001100000010001
100000000000000011010100100011                 11111
11000001110101011111011110N0111                10001
11110111 1110101 101111010001                  11111
11111111 1111111 11111111111