NO textures/wall.xpm
SO textures/wall.xpm
WE textures/wall.xpm
EA textures/lana.xpm

F 220,100,2
C 225,30,0

		1111111111111111111111111
		1000000000110000000000001
		1011011111111111111111001
11111111111111111            1011
11111111111111111111111111111111
1000000000110000011101111111100111
11110111111111010100000010000001
1111011111111101110101001000111
11000000110101011100000010001
10000000000000001100000010001
100000000000000011010100000011
11000001110101011111011100N111
11110111 1110101 101111010001
11111111 1111111 111111111111