NO textures/wall.xpm
SO textures/wall.xpm
WE textures/wall.xpm
EA textures/lana.xpm

F 220,100,2
C 225,30,0

		1111111111111111111111111
		1000000000110000000000001
		1011011111111111111111001
11111111111111111            1011
11111111101111111111111111111111
1000000010110000111101111111100111
111011111011101010100000100000011
111101111111110111010100100011111
111111111111111111111111110011111
11111111111111111111111111111111
100000011111000011000000100011111
10000001   1000000000110101000011
1100000111110101111101110N111111
11110111 1110101 101111010001
11111111 1111111 111111111111